1;1;N;1;1
1;CN;X;C;1
1;1;X;1;1
1;CC;X;P;1
1;1;1;1;1
